

SO ./textures/south.xpm

WE ./textures/west.xpm

NO ./textures/north.xpm

EA ./textures/east.xpm

F 92,91,86 
C 100,120,140

        1111111111111111111111111
        1000000000110000000000001
        1011000001110000000000001
        1001000000000000000000001
111111111011000001110000000000001
100000000011000001110111111111111
11110111111111011100000000001
11110111111111011101110100001
11000000110101011100100101001
10000000000000001100100111001
10000000000000001101010000001
11000001110101011111011100E0111
11110111 1110101 101111010001
11111111 1111111 111111111111