SO ./textures/south.xpm
WE ./textures/west.xpm
NO ./textures/north.xpm
EA ./textures/east.xpm

F  2, 41,15
C  121,136,137

1111111111111111111111111
1000001000000000100000001
1011101011110111101110101
1000101000010000100010101
1110101111010111101010101
1000100000010100001010001
1010111111010101111010111
1010000000010101000010001
1010111111110101011110101
1010001000000101010000101
1111101011111101010111101
1000001010000001010000001
101111101000S0000010111111
1000000010100000010000001
1011111110101111111111101
1000000000101000000000101
1011110111101011110110101
1000010000001010000010001
1111010111111010111110101
1000010000000010000010001
1011111011111110111110101
1000001000000000100000001
1011111111111111111111101
1000000000000000000000001
1111111111111111111111111