SO ./textures/south.xpm
WE ./textures/west.xpm
NO ./textures/north.xpm
EA ./textures/east.xpm

F 210,180,140
C 135,164,185

        11111111111111111111
        1001001001001001000
        1001001010101001001
        1001001001001001001
1001001000001001001
100000000000000S001
1000011111111000001
1111000000000001111
1000000101010000001
1111111111111111111